***************
*.............*
*.**.**.**.**.*
*.*...*.*..*..*
*.*.*.*.*.**..*
*.............*
*.***.***.**.**
*...*.........*
**..**.**.*..**
*.........*...*
*.*.*.***.**..*
*.*.....*..*..*
*.**.**.*.**..*
*.............*
***************